YNNNNNYYYY
YYYNNYYNNY
YNYYYYNNYY
NYYNNNNNYN
YYNNNNYYYN
NYYYNNYNNN
YYNYNNYYYN
YNNYYYYNYY
YNNYNNNNNY
YYYYNNNNNY